pacman
****************************************
*   *   * *  ***************************
* *   * *    ***************************
* * *** * ** ***************************
* *        *****************************
* ** * ***     *************************
* *  *     *** *************************
* * ** *** * * *************************
*   *    * *     ***********************
* *    *   * * * ***********************
* **** *** *** * ***********************
* *    *       * ***********************
*   *    * ***** ***********************
* * * **** *     ***********************
* * *   ** * ***************************
* *   *      ***************************
* *** **********************************
* *     ********************************
* * *** ********************************
* *   * ********************************
*   *   ********************************
****************************************